donphanatic -> someone asked for me to bring my switch to work so i lent it to them this morning and they ended up with like 10 people watching 
dreamteam -> switch set to get resident evil 7 
herrdekay -> rt 505games swordorwhip is coming to the nintendo switch get all the details in the latest backer update 
afe -> rt domocashaw shit hurt my heart to see someone switch up on me like they did
morgan -> rt jaynehardy a little something i wrote for virgin - chasing balance is futile there is no such thing - switch off 
day -> dont switch on me i got big plans
currywurst -> i love that game 
fadhlispencer -> rt tasneemobeid3 you can switch it off they cant 
pietrasz -> rt patthenespunk cupodcast 94 - nintendo switch and zelda botw break sales records colin moriarty leaves kinda funny logan more htt
cosma -> with the whole lastpass debacle i moved back to dashlane thats until i find some time to switch to keepass
kirreblume -> rt 505games swordorwhip is coming to the nintendo switch get all the details in the latest backer update 
lamothe -> thanks to takealot for my phat switch pre-order lewt 
pattnaik -> mykitchenrules feels like seven year switch thanks to josh and amy mkr
javed -> rt etribune roshan pakistan scheme 20000 houses to switch to solar energy system
adewale -> trending post audio  video dj switch  clap for dem 
face -> dont switch on me i got big plans
ade -> errrgod saved me the morafucker came to rob and then tried to switch gears 
jenn -> rt gamesfund you could win a nintendo switch to enter our prize competition giveaway simply follow retweet us see at 
jualbeli -> nintendo switch us ver bnob brand new kincling2  bundle zelda murah - jogja  
khanyie -> rt lumkokazi we switch locations and its all still dope af cause theyre cool ass people and this guy is cute so im for it
duelist -> itam switch zelda bundle giveaway 
musicali -> amplificatore per chitarra elettrica peavey bandit 65  switch  musicali musica musicista musicaitaliana
devore -> rt forevermonai i just hope you never switch up on me  
lisaaa -> rt breezaayy never switch up on mountain dew smh 
lilsouljadolce -> rt jamescharles att your services are a joke im paying 50 a month to literally switch off my wifi in order for anything to send or pos
soon -> rt shabetpink when you see that someone has you blocked so you switch over to your saved acc to check if they tweeted about you 
teichmann -> murlionline i am using 2 users via sso cert and 1 via usernamepw when i log off  on again the same user is logged no switch possible
borland -> catherinerusse2 bbc i would imagine it is very draining acting such an emotional story are you abke to switch off straight away 
smudgedan -> mozeight looks like my 11 isa switch is a tad optimistic
mahonny -> im in the running to win a nintendoswitch courtesy of ticgamenetwork 
mahonny -> rt fameent2k enter to win our nintendoswitch giveaway for the fans by the fans  bubb -> rt stpiindia meal voucher firms like sodexo must switch to digital format by 2017-end rbi 
ashton -> rt bhaardy dont trust familythey switch up and act fake too fuck them stay to yourself
sam -> rt kirillklip lithium theswitch $ilcv is actively engaging in the investigation and identification of strategic opportunities 
harley -> covertfade gspellchecker only a problem if it takes considerable force to activate otherwise switch style electromagnets would be used
duelist -> i entered to win a switch and breath of the wild from intotheam you can too 
lewis -> rt standardnews drivers switch off part of brain when using satnavs research shows 
singh -> rt vijayprashad filed for frontlineindia on the trump budget -  the switch from economic to cultural sovereignty
hlb -> casually abt to switch up mfs 
thaps -> uhmmmsquire lmao yeah man hes been singing yo he needs to switch up
yammouni -> rt jamesyammouni fuck them bro rebellyus 
taylor -> thank god for his grace and mercyso happy and glad god touched the idiot heart sha 
harwood -> rt gamesfund you could win a nintendo switch to enter our prize competition giveaway simply follow  retweet us see at 
parts -> mercedes w111w109w114w108 lighted rear window defrost 1 switch  
nbps -> rt mrmossfablab samantha bernstein 6th grade with her slide along happy birthday led candle birthday card
movie -> switch brings more emphasis on kahayla classic 
support -> genessis can you try a different connection if you are on data can you switch to wi-fi please let us know if that helps 
lowry -> the question every company asks itself 
talk2globe -> arjayslife seconds then disable it and monitor for any improvements after a few minutes you may also switch off your 36
talk2globe -> arjayslife device wait 10 to 15 seconds then switch it back on then observe for 5 minutes for any positive changes 46
jayden -> rt kylecmpbell dont switch on me i got big plans
medina -> the last nintendo console i had was an snes got high hopes for you switch  
campbell -> andrewgrimes what they dont tell you turning the headphones on is good way to connect and press play on the headphones to switch audio
news -> the nintendo switch was almost an android device but cyanogen said no related articles
tucker -> rt shabetpink when you see that someone has you blocked so you switch over to your saved acc to check if they tweeted about you 
cobian -> now i can play my switch lol
timo -> time for a switch nintendo switch 
shiro -> i liked a youtube video from rttheknow  switch more successful than wii  no witcher 4 sorry  suicide
h -> rt guardianteach there are many benefits to sourcing food locally so how can schools make the switch 
viivixv -> switch - i call your name 
phil -> rt keez634 switch - i call your name 
citizen -> switch needs a pc dock 
mimz -> nintendo switch zelda bundle giveaway 